50:40
xxxxxxxxxxxxxxxxxxxxxxxxxxxxxxxxxxxxxxxxxxxxxxxxxx
x321               x         x         E         x
x21                x         x                   x
x1                 x         x                   x
x                  x         x                   x
x                  x         x                   x
x                  x         x                   x
x                  x         x                   x
x                  x         x                   x
x                  x         x                   x
xxxxxxxxxxxxxx     x         x                   x
x                  x         x                   x
x                  x         x                   x
x                  x         x                   x
x                                                x
x                                                x
x                                                x
x                                                x
x                  x         x                   x
x                  x         x                   x
x                  x         x                   x
x                  x         x                   x
xxxxxxxxxxxxxxxxxxxx         xxxxxxxxxxxxxxxxxxxxx
x                  x         x                   x
x                  x         x                   x
x                  x         x                   x
x                  x         x                   x
x                  x         x                   x
x                  x         x                   x
x                                                x
x                                                x
x                                                x
x          xxxxxxxxx         x                   x
x          x                 x                   x
x          x                 x                   x
x          x                 x                   x
x          x                 x                   x
x          x                 x                   x
x          x                 x                   x
xxxxxxDxxxxxxxxxxxxxxxxxxxxxxxxxxxxxxxxxxxxxxxxxxx
